NO ./texture/IJ.xpm
   	
        
SO ./texture/CL.xpm
WE ./texture/PC.xpm
EA      ./texture/GO.xpm


F 56,56,56
C 255,231,166


        1111111111111111111111111
        1000000000110000000000001
        1011000001110000000000001
        1001000000000000000000001
111111111011000001110000000000001
100000000011000001110111111111111
11110111101111011100000010001
11111111101111111111111111111
        101
11111111101111111111111111111
11110111101111011101010010001
11000000100101011100000000001
10000000000000000000000010001
10000000000000001101010010001
11000001110101011111011110N0111
11110111 1110101 101111010001
11111111 1111111 111111111111